! # = Tile Legend 
! 1 = tileWall
! 2 = door
! 3 = desk
! 4 = chair
! 5 = safe
! 6 = camera
! 7 = computer

111111111111111111111111  
1      61              1  
15      2    4     4   1  
1       1   333   333  1  
111111111              1  
        1              1  
        1              1  
        1        1111111  
        1        1 4 4 1  
        1       43     1  
        1        3     2  
        1              1  
        1121111111111111  
        1    1            
        1    1            
        1   71            
        111111            
                          